

REAMONN - SUPERGIRL
YOUNOTUS & JULIAN PERRETTA - YOUR FAVOURITE SONG
NEA - SOME SAY
DECLAN J. DONOVAN - PIECES
HALSEY - YOU SHOULD BE SAD
CLEAN BANDIT AND MABEL FT. 24GOLDN - TICK TOCK
ADEL TAWIL - LIEDER
RITA ORA - YOUR SONG
GEORGE MICHAEL - FAITH
ONE REPUBLIC - GOOD LIFE
MAROON 5 - GIRLS LIKE YOU
MARK FORSTER - 194 LÃ½NDER
MILOW - YOU DON'T KNOW
IMAGINE DRAGONS - WHATEVER IT TAKES
CH-KUNZ - LýýT SO WIE MER
SHAWN MENDES - THERE'S NOTHING HOLDIN' ME BACK
KATY PERRY - I KISSED A GIRL
WINCENT WEISS - HIER MIT DIR
DERMOT KENNEDY - POWER OVER ME
LP - GIRLS GO WILD
DANIEL POWTER - BAD DAY
ED SHEERAN - GALWAY GIRL
LABRINTH FT EMELI SANDE - BENEATH YOUR BEAUTIFUL
GEORGE EZRA - PARADISE
BEYONCE - IF I WERE A BOY
CH-STEFANIE HEINZMANN FT. JAKE ISAAC - ALL WE NEED IS LOVE
ONE REPUBLIC - SOMETHING I NEED
ALLE FARBEN & CH-ILIRA - FADING
ZOE WEES - CONTROL
MASTER KG FT. BURNA BOY & NOMCEBO ZIKODE - JERUSALEMA
BENJI & FEDE - DOVE E QUANDO
NICO SANTOS - PLAY WITH FIRE
CH-PEGASUS - BETTER MAN
ED SHEERAN - I SEE FIRE