

CH-ZIAN - SHOW YOU
MAROON 5 FT CHRISTINA AGUILERA - MOVES LIKE JAGGER
YOUNOTUS & JULIAN PERRETTA - YOUR FAVOURITE SONG
DOTAN - NUMB
TOM WALKER - JUST YOU AND I
DANTE THOMAS - MISS CALIFORNIA
BASTILLE - GOOD GRIEF
ALLE FARBEN & CH-ILIRA - FADING
MILEY CYRUS - MIDNIGHT SKY
CH-PEGASUS - BETTER MAN
TOM GREGORY - RATHER BE YOU
JOE COCKER - SUMMER IN THE CITY
CH-STEFANIE HEINZMANN - IN THE END
ED SHEERAN - AFTERGLOW
SHAWN MENDES - STITCHES
THE VERVE - BITTER SWEET SYMPHONY
LP - LOST ON YOU
GLASPERLENSPIEL - GEILES LEBEN
UNDERDOG PROJECT - SUMMER JAM
SEAN PAUL - SHE DOESN'T MIND
ZUCCHERO - BAILA
TAKAGI & KETRA GIUSY FERRERI & SEAN KINGSTON - AMORE E CAPOEIRA
FLO RIDA - WHISTLE
EMILIANA TORRINI - JUNGLE DRUM
CH-DJ ANTOINE VS MAD MARK - BELLA VITA
CULTURE BEAT - MR VAIN
TONES AND I - DANCE MONKEY
ALVARO SOLER FT. JENNIFER LOPEZ - EL MISMO SOL
KID ROCK - ALL SUMMER LONG
SHAKIRA - HIPS DON'T LIE
JENNIFER LOPEZ FT PITBULL - ON THE FLOOR
CH-LUCA HÃƒÆ’Ã¢â‚¬Å¾NNI - SHE GOT ME
PEDRO CAPO & FARRUKO - CALMA
CH-HECHT - BRISSAGO
WES - ALANE
THE EAGLES - HOTEL CALIFORNIA
EDUARDO BENNATO & GIANNA NANNINI - UN'ESTATE ITALIANA
CH-HECHT - PROSECCO
KATE YANAI - SUMMER DREAMING
DAVID HASSELHOFF - DO THE LIMBO DANCE
ALLE FARBEN - BAD IDEAS
INNER CIRCLE - SWEAT
CH-LOCO ESCRITO - PUNTO
CH-LO & LEDUC - 079
CH-DJ ANTOINE FT TIMATI & KALENNA - WELCOME TO ST. TROPEZ
JUANES - LA CAMISA NEGRA
CH-KUNZ - CHLIINI HÃƒâ€žND
CH-KUNZ - CHLIINI HÃ„ND
LOST FREQUENCIES - ARE YOU WITH ME
TOM GRENNAN - LITTLE BIT OF LOVE
THE WEEKND - BLINDING LIGHTS
OLIVIA RODRIGO - GOOD 4 U
KATRINA&THE WAVES - WALKING ON SUNSHINE
RIGHEIRA - VAMOS A LA PLAYA
2RAUMWOHNUNG - 36 GRAD
CH-PATENT OCHSNER - FÜR IMMER UF DI
CH-REMADY & MANU-L - HOLIDAYS
CH-LOCO ESCRITO - MAMACITA.
LOONA - BAILANDO