

DJ ÃƒÆ’Ã†â€™Ãƒâ€ Ã¢â‚¬â„¢ÃƒÆ’Ã‚Â¢ÃƒÂ¢Ã¢â‚¬Å¡Ã‚Â¬ÃƒÂ¢Ã¢â€šÂ¬Ã…â€œTZI & MARC PIRCHER - 7 SÃƒÆ’Ã†â€™Ãƒâ€ Ã¢â‚¬â„¢ÃƒÆ’Ã¢â‚¬Â¦ÃƒÂ¢Ã¢â€šÂ¬Ã…â€œNDEN
HOZIER - TAKE ME TO CHURCH
PINK - TRY
FOREIGNER - I WANT TO KNOW WHAT LOVE IS
DERMOT KENNEDY - GIANTS
SMOKIE - LIVING NEXT DOOR TO ALICE
CH-LO & LEDUC - FÃƒÆ’Ã†â€™Ãƒâ€¦Ã¢â‚¬Å“R INGWER UND EWIG
RED HOT CHILI PEPPERS - OTHERSIDE
DEPECHE MODE - ENJOY THE SILENCE
NIALL HORAN - SLOW HANDS
MAX GIESINGER - LEGENDEN
AVICII FT. CHRIS MARTIN - HEAVEN
JONAS BROTHERS - WHAT A MAN GOTTA DO
ROBBIE WILLIAMS - LET ME ENTERTAIN YOU
ROD STEWART - SAILING
BRUCE SPRINGSTEEN - BORN IN THE USA
TONES AND I - UR SO F**KING COOL
DON HENLEY - BOYS OF SUMMER
LADY GAGA - BORN THIS WAY
LINKIN PARK - BURN IT DOWN
MARK FORSTER - CHÃƒÆ’Ã¢â‚¬â€œRE
WHITNEY HOUSTON - ONE MOMENT IN TIME
EMINEM FT. ED SHEERAN - RIVER
AVA MAX - SWEET BUT PSYCHO
CH-HENRIK BELDEN - CATHLEEN
JORIS - HERZ ÃƒÅ“BER KOPF
FALCO - OUT OF THE DARK
VANCE JOY - RIPTIDE
WOLFGANG PETRY - VERLIEBEN VERLOREN VERGESSEN VERZEIHEN
CH-LOCO ESCRITO - SIN TI
DIRE STRAITS - BROTHERS IN ARMS
BONNIE TYLER - TOTAL ECLIPSE OF THE HEART
BONEY M - RIVERS OF BABYLON
JOHN LENNON - IMAGINE
CH-DODO FT. DABU FANTASTIC - BRÃœTIGAM
ED SHEERAN & JUSTIN BIEBER - I DON'T CARE
ONE DIRECTION - WHAT MAKES YOU BEAUTIFUL
LYNYRD SKYNYRD - SWEET HOME ALABAMA
CH-GOTTHARD - ANYTIME ANYWHERE
CH-STEFF LA CHEFFE - HOLUNDER
WHITNEY HOUSTON - I WILL ALWAYS LOVE YOU
CH-LOCO ESCRITO - MI CULPA
JOHN FARNHAM - YOU'RE THE VOICE
HERBERT GRÖNEMEYER - MÄNNER
ZUCCHERO - BAILA
POST MALONE FT. 21 SAVAGE - ROCKSTAR