

IMAGINE DRAGONS - BIRDS
CH-STEFANIE HEINZMANN - COLORS
AVA MAX - TORN
FREYA RIDINGS - CASTLES
PINK FLOYD - ANOTHER BRICK IN THE WALL
THE WEEKND - SAVE YOUR TEARS
LEWIS CAPALDI - BEFORE YOU GO
NICO SANTOS - PLAY WITH FIRE
JOAN JETT & THE BLACKHEARTS - I LOVE ROCK'N'ROLL
PITBULL FT CHRISTINA AGUILERA - FEEL THIS MOMENT
LINKIN PARK - BURN IT DOWN
DENNIS LLOYD - ANXIOUS
ZAYN FT. SIA - DUSK TILL DAWN
NELLY FURTADO - ALL GOOD THINGS (COME TO AN END)
TARKAN - SIMARIK
WINCENT WEISS - MUSIK SEIN
ALOE BLACC & PEGASUS - GREATEST SHOW ON EARTH
IMAGINE DRAGONS - RADIOACTIVE
DYNORO FT. GIGI D'AGOSTINO - IN MY MIND
AVA MAX - SO AM I
GREEN DAY - 21 GUNS
OFENBACH & QUARTERHEAD FT. NORMA JEAN MARTINE - HEAD SHOULDERS KNEES & TOES
JASON DERULO - TAKE YOU DANCING
RAY DALTON - IN MY BONES
BEATLES - HELP
KYGO & ONE REPUBLIC - LOSE SOMEBODY
CULTURE BEAT - MR VAIN
TOM GREGORY - FINGERTIPS
ANNE-MARIE - 2002
PINK FT NATE RUESS - JUST GIVE ME A REASON
ALLE FARBEN & JANIECK - LITTLE HOLLYWOOD
CH-BASTIAN BAKER - DANCING WITHOUT YOU
JAMES BLUNT - THE TRUTH
ARGYLE SINGH - BY YOUR SIDE
RAY DALTON - GOOD TIMES HARD TIMES
TOM WALKER - JUST YOU AND I
ONE REPUBLIC - GOOD LIFE
JUSTIN TIMBERLAKE - CAN'T STOP THE FEELING!
ROBBIE WILLIAMS - FEEL
YOUNOTUS & JULIAN PERRETTA - YOUR FAVOURITE SONG
HARRY STYLES - WATERMELON SUGAR
TOM GRENNAN - LITTLE BIT OF LOVE
ROY ORBISON - PRETTY WOMAN
MIKE POSNER - I TOOK A PILL IN IBIZA
MASTER KG FT. BURNA BOY & NOMCEBO ZIKODE - JERUSALEMA
TWOCOLORS - LOVEFOOL
MELANIE FIONA - GIVE IT TO ME RIGHT