

CH-ZÃƒÆ’Ã†â€™Ãƒâ€šÃ‚Â½RI WEST - I HA DI GÃƒÆ’Ã†â€™Ãƒâ€šÃ‚Â½RN GHA
PHIL COLLINS - YOU CAN'T HURRY LOVE
VILLAGE PEOPLE - YMCA
CH-LO & LEDUC - TRIBUT
EMILIANA TORRINI - JUNGLE DRUM
KYGO FT. DONNA SUMMER - HOT STUFF
LINKIN PARK - WHAT I'VE DONE
KUNGS VS. COOKIN' ON 3 BURNERS - THIS GIRL
TONES AND I - DANCE MONKEY
ED SHEERAN - CASTLE ON THE HILL
MACKLEMORE FT ZIGGY STARDUST - AND WE DANCED
ERIC PRYDZ - CALL ON ME
FA-BORGGEISCHTER-MUSIG ROTEBORG - ABBA
BON JOVI - RUNAWAY
MONTY PYTHON - ALWAYS LOOK ON THE BRIGHT SIDE OF LIFE
THE BLOODHOUND GANG - THE BAD TOUCH
ELECTRIC LIGHT ORCHESTRA - DONT BRING ME DOWN
HOWARD CARPENDALE - TI AMO
RIHANNA - DON'T STOP THE MUSIC
FIVE - KEEP ON MOVIN'
ED SHEERAN FT. FELIX JAEHN - PHOTOGRAPH
ROBIN SCHULZ FT. KIDDO - ALL WE GOT
DIE PRINZEN - DÃƒÆ’Ã‚Â½RFEN DARF MAN ALLES
VIZE & TOM GREGORY - NEVER LET ME DOWN
JONAS BROTHERS - WHAT A MAN GOTTA DO
TAYLOR SWIFT - SHAKE IT OFF
AVA MAX - MY HEAD & MY HEART
TRAIN - HEY SOUL SISTER
KUNGS FT. JAMIE N COMMONS - DON'T YOU KNOW
ROBBIE WILLIAMS - LET ME ENTERTAIN YOU
LOUD LUXURY FT. BRANDO - BODY
MILEY CYRUS - MIDNIGHT SKY
HELENE FISCHER - ATEMLOS DURCH DIE NACHT
TAKAGI & KETRA GIUSY FERRERI & SEAN KINGSTON - AMORE E CAPOEIRA
ROXETTE - JOYRIDE
TIM TOUPET - SO EIN SCHÃƒÂ½NER TAG (FLIEGERLIED)
ABBA - DANCING QUEEN
THE WEEKND - SAVE YOUR TEARS
JAX JONES FT. RAYE - YOU DON'T KNOW ME
CH-KUNZ - AFF
ANDREAS GABALIER - I SING A LIED FÃ½R DI
JUSTIN TIMBERLAKE - ROCK YOUR BODY
INNER CIRCLE - SWEAT
JOHANNES OERDING - AN GUTEN TAGEN
GALANTIS FT. ONE REPUBLIC - BONES
OFENBACH & QUARTERHEAD FT. NORMA JEAN MARTINE - HEAD SHOULDERS KNEES & TOES
SIGALA - EASY LOVE
MASTER KG FT. BURNA BOY & NOMCEBO ZIKODE - JERUSALEMA
MARK RONSON FT AMY WINEHOUSE - VALERIE
EDWARD MAYA & VIKA JIGULINA - STEREO LOVE
MICHAEL JACKSON - THE WAY YOU MAKE ME FEEL
DAVID GUETTA & SIA - LET'S LOVE
ALAN WALKER - ALONE
REGARD - RIDE IT
LOREEN - EUPHORIA
PURPLE DISCO MACHINE & SOPHIE AND THE GIANTS - HYPNOTIZED
SCISSOR SISTERS - I DON'T FEEL LIKE DANCIN
CH-DODO - HIPPIE-BUS
FA-BURGSCHRýNZER HOHENRAIN - YOU SHOOK ME ALL NIGHT LONG
JOAN JETT & THE BLACKHEARTS - I LOVE ROCK'N'ROLL
ABBA - MAMMA MIA
BLONDIE - MARIA
DIANA ROSS - UPSIDE DOWN
EARTH WIND & FIRE - BOOGIE WONDERLAND
KYGO & WHITNEY HOUSTON - HIGHER LOVE
ED SHEERAN - SHAPE OF YOU
ROBIN SCHULZ & J.U.D.G.E. - SHOW ME LOVE