

DIE TOTEN HOSEN - STEH AUF WENN DU AM BODEN BIST
DAVID GUETTA FT SIA - TITANIUM
SIDO - BILDER IM KOPF
CH-LO & LEDUC - JUNG VERDAMMT
PANIC! AT THE DISCO - HIGH HOPES.
ZZ TOP - GIMME ALL YOUR LOVIN'
ABBA - CHIQUITITA
ANDREAS GABALIER - I SING A LIED FÃƒÆ’Ã…â€œR DI
A-HA - TAKE ON ME
CH-GOTTHARD - LIFT U UP
ROXETTE - JOYRIDE
DAVID HASSELHOFF - LOOKING FOR FREEDOM
SHAWN MENDES & CAMILA CABELLO - SENORITA
CH-MARASH & DAVE FT LCONE - 041
AVICII - HEY BROTHER
THE SCRIPT FT WILL.I.AM - HALL OF FAME
CH-SEVEN - LISA
CH-KUNZ - OLTEN
METALLICA - ONE
COLDPLAY - FIX YOU
ELVIS PRESLEY - IN THE GHETTO
CH-PAULA DALLA CORTE FT. REA GARVEY & SAMU HABER - SOMEONE BETTER
CH-STEFANIE HEINZMANN - MOTHER'S HEART
QUEEN - I WANT IT ALL
JOHN DENVER - COUNTRY ROADS
HARRY STYLES - SIGN OF THE TIMES
COLDPLAY - YELLOW
PASSENGER - LET HER GO
WINCENT WEISS - HIER MIT DIR
CH-ADRIAN STERN - HA NOR WELLE WÃƒâ€“SSE
CH-HECHT - SURFER
MICHAEL JACKSON - BILLIE JEAN
BEN ZUCKER - NA UND?!
CH-DODO - ZÃœRIMAA
CH-RUEDI RYMANN - DR SCHACHER SEPPLI
CH-PATENT OCHSNER - TRYBGUET
SIDO FT. ANDREAS BOURANI - ASTRONAUT
JAN MARTEN BLOCK - NEVER NOT TRY
CH-LO & LEDUC - IM ERSCHTE TRAM
ABBA - SUPER TROUPER
LEWIS CAPALDI - SOMEONE YOU LOVED
ED SHEERAN - SHAPE OF YOU
CH-77 BOMBAY STREET - UP IN THE SKY
JASON DERULO - TAKE YOU DANCING
HELENE FISCHER - ICH WILL IMMER WIEDER... DIESES FIEBER SPÜRN
PINK FT NATE RUESS - JUST GIVE ME A REASON
IMAGINE DRAGONS - THUNDER
BON JOVI - BED OF ROSES