

MAROON 5 FT CHRISTINA AGUILERA - MOVES LIKE JAGGER
WEATHER GIRLS - IT'S RAINING MEN
DUA LIPA - PHYSICAL
ONE REPUBLIC - RUN.
MEDUZA FT. DERMOT KENNEDY - PARADISE..
DAVID GUETTA & SIA - LET'S LOVE
THE KID LAROI - WITHOUT YOU.
FREYA RIDINGS - CASTLES
CH-LOCO ESCRITO - MAMACITA.
OLIVIA RODRIGO - GOOD 4 U
JUSTIN BIEBER - SORRY
MARTIN GARRIX FT. BONO & THE EDGE - WE ARE THE PEOPLE.
KYGO FT. TINA TURNER - WHAT'S LOVE GOT TO DO WITH IT
MASTER KG FT. BURNA BOY & NOMCEBO ZIKODE - JERUSALEMA
ED SHEERAN - AFTERGLOW
ROBIN SCHULZ FT. KIDDO - ALL WE GOT
WINCENT WEISS - WER WENN NICHT WIR
TAYLOR SWIFT - BLANK SPACE
CH-NICKLESS - WAITING
AVA MAX - KINGS & QUEENS
TOM GREGORY - RIVER
CH-JOYA MARLEEN - NIGHTMARE
DUA LIPA - LOVE AGAIN
COLDPLAY - HIGHER POWER
MILOW - WHATEVER IT TAKES.
JOEL CORRY FT. MNEK - HEAD & HEART
MICHAEL PATRICK KELLY - THROWBACK
LINKIN PARK AND KIIARA - HEAVY
MADCON - BEGGIN
CH-LUCA HÃ„NNI - SHE GOT ME
JONAS BROTHERS FT. KAROL G - X
WINCENT WEISS - MUSIK SEIN
FAITH NO MORE - EASY
JESSIE J FT B.O.B. - PRICE TAG
DOTAN - NUMB
ZOE WEES - CONTROL
JUSTIN WELLINGTON FT. SMALL JAM - IKO IKO
CH-KUNZ - SETTIG MOMÄNTE
ED SHEERAN FT. KHALID - BEAUTIFUL PEOPLE