

OLLY MURS FT. RIZZLE KICKS - HEART SKIPS A BEAT
CH-JOYA MARLEEN - NIGHTMARE
TOM GREGORY - RATHER BE YOU
JONAS BROTHERS - SUCKER
OUTLANDISH - AICHA
ENRIQUE IGLESIAS - SUBEME LA RADIO
PINK - TRY
ADEL TAWIL - 1000 GUTE GRÃœNDE
TOM WALKER - LEAVE A LIGHT ON
CH-DAMIAN LYNN - BLINK OF AN EYE
JUSTIN WELLINGTON FT. SMALL JAM - IKO IKO
TAKAGI & KETRA & OMI & GIUSY FERRERI - JAMBO
DAVID GUETTA & SIA - FLAMES
LADY GAGA - POKER FACE
WINCENT WEISS - MUSIK SEIN
OLLY MURS FT DEMI LOVATO - UP
SHAKIRA FT. ALEJANDRO SANZ - LA TORTURA
HARRY STYLES - WATERMELON SUGAR
SAM SMITH - DIAMONDS.
MAROON 5 - MEMORIES
AVA MAX - EVERYTIME I CRY
JAMES ARTHUR - FALLING LIKE THE STARS
QUEEN - ANOTHER ONE BITES THE DUST
TOM GREGORY - RIVER
DOTAN - NUMB
THE WEEKND - SAVE YOUR TEARS
RAG'N'BONE MAN - ALL YOU EVER WANTED
AVICII FT. SANDRO CAVAZZA - WITHOUT YOU
ANASTACIA - I'M OUTTA LOVE
PINK FT. WILLOW SAGE HART - COVER ME IN SUNSHINE
LP - GIRLS GO WILD
SUNRISE AVENUE - HEARTBREAK CENTURY
RED HOT CHILI PEPPERS - CALIFORNICATION
SIDO - BILDER IM KOPF
TOM GREGORY - SMALL STEPS