

LAUREN DAIGLE - YOU SAY
ROBIN SCHULZ FT. KIDDO - ALL WE GOT
ONE DIRECTION - STORY OF MY LIFE
RIHANNA & KANYE WEST & PAUL MCCARTNEY - FOURFIVESECONDS
JAMES ARTHUR - FALLING LIKE THE STARS
MEDUZA FT. DERMOT KENNEDY - PARADISE..
MILKY CHANCE - STOLEN DANCE
KYGO FT. PARSON JAMES - STOLE THE SHOW
AURA DIONE - I WILL LOVE YOU MONDAY
JAMES BAY - HOLD BACK THE RIVER
TOM WALKER - JUST YOU AND I
WINCENT WEISS - HIER MIT DIR
EVANESCENCE - MY IMMORTAL
CALVIN HARRIS - MY WAY
THE SCRIPT FT WILL.I.AM - HALL OF FAME
MIKE POSNER - I TOOK A PILL IN IBIZA
LUTRICIA MCNEAL - AIN'T THAT JUST THE WAY
YOUNOTUS & JULIAN PERRETTA - YOUR FAVOURITE SONG
KYGO FT. TINA TURNER - WHAT'S LOVE GOT TO DO WITH IT
GEORGE EZRA - PARADISE
JAMES BLUNT - 1973
NICKELBACK - SONG ON FIRE
PINK FT. WILLOW SAGE HART - COVER ME IN SUNSHINE
MARSHMELLO FT. BASTILLE - HAPPIER.
OUTKAST - HEY YA
AVICII FT. ALOE BLACC - SOS
COLDPLAY - PARADISE.
CH-CRIMER - EYES OFF ME
NEA - SOME SAY
AVA MAX - MY HEAD & MY HEART
THE WEEKND - IN YOUR EYES
DERMOT KENNEDY - OUTNUMBERED
SAM SMITH - DIAMONDS.
THE FAIM - SUMMER IS A CURSE
JAMES BAY - CHEW ON MY HEART
KINGS OF LEON - SEX ON FIRE
AXWELL & INGROSSO - MORE THAN YOU KNOW
OLLY MURS FT DEMI LOVATO - UP
ROBIN SCHULZ & WES - ALANE
FERGIE - BIG GIRLS DON'T CRY
JONAS BROTHERS - WHAT A MAN GOTTA DO
PINK FT. CASH CASH - CAN WE PRETEND
NATHAN EVANS - WELLERMAN (SEA SHANTY)
REAMONN - TONIGHT.
MADCON FT. RAY DALTON - DON'T WORRY
LOREEN - EUPHORIA
MABEL - DON'T CALL ME UP
BLUE - ALL RISE
MAROON 5 - MEMORIES
MASTER KG FT. BURNA BOY & NOMCEBO ZIKODE - JERUSALEMA
OLIVIA RODRIGO - DRIVERS LICENSE
CRAZY TOWN - BUTTERFLY
EMINEM FT. ED SHEERAN - RIVER
GEORGE EZRA - BLAME IT ON ME
RUDIMENTAL FT. JESS GLYNNE MACKLEMORE & DAN CAPLEN - THESE DAYS
COLDPLAY - VIVA LA VIDA
MARK FORSTER - Ã½BERMORGEN
CH-JOYA MARLEEN - NIGHTMARE
SOPHIE AND THE GIANTS - RIGHT NOW
REM - LOSING MY RELIGION
MAX GIESINGER - 80 MILLIONEN
DOTAN - THERE WILL BE A WAY
LP - GIRLS GO WILD
MICHAEL JACKSON - BAD
CLEAN BANDIT AND MABEL FT. 24GOLDN - TICK TOCK
ARGYLE SINGH - BY YOUR SIDE
AVA MAX - KINGS & QUEENS
HOOBASTANK - THE REASON