

TOM GREGORY - RATHER BE YOU
ALVARO SOLER - MAGIA
DEEP BLUE SOMETHING - BREAKFAST AT TIFFANY'S
ALAN WALKER - FADED
MILOW - ASAP
RAY DALTON - GOOD TIMES HARD TIMES
JONAS BROTHERS - WHAT A MAN GOTTA DO
LEONY - FADED LOVE
ED SHEERAN - AFTERGLOW
FREYA RIDINGS - CASTLES
MARTIN GARRIX FT. BONO & THE EDGE - WE ARE THE PEOPLE.
SHEPPARD - GERONIMO
IMAGINE DRAGONS - FOLLOW YOU
MEDUZA FT. DERMOT KENNEDY - PARADISE..
ZOE WEES - CONTROL
THE KID LAROI FT. JUSTIN BIEBER - STAY
TOM GREGORY - SMALL STEPS
ONE REPUBLIC - RUN.
LADY GAGA - BAD ROMANCE
JAMES ARTHUR - NAKED
BON JOVI - YOU GIVE LOVE A BAD NAME
SIA - THE GREATEST
HOZIER - TAKE ME TO CHURCH
POST MALONE - CIRCLES
REA GARVEY - KISS ME
JUSTIN TIMBERLAKE - CRY ME A RIVER
GOTYE FT KIMBRA - SOMEBODY THAT I USED TO KNOW
DERMOT KENNEDY - GIANTS
OFENBACH & QUARTERHEAD FT. NORMA JEAN MARTINE - HEAD SHOULDERS KNEES & TOES
MIMI WEBB - GOOD WITHOUT
DAVID GUETTA FT KELLY ROWLAND - WHEN LOVE TAKES OVER
LADY GAGA - PAPARAZZI
PORTUGAL. THE MAN - FEEL IT STILL
SHAKIRA FT. ALEJANDRO SANZ - LA TORTURA