

AVA MAX - SO AM I
RONAN KEATING - WHEN YOU SAY NOTHING AT ALL
LINKIN PARK - BURN IT DOWN
MARK FORSTER - CHÃ½RE
KYGO & WHITNEY HOUSTON - HIGHER LOVE
MICHAEL JACKSON - BILLIE JEAN
ADELE - SOMEONE LIKE YOU
WINCENT WEISS - HIER MIT DIR
OFENBACH & QUARTERHEAD FT. NORMA JEAN MARTINE - HEAD SHOULDERS KNEES & TOES
MANDO DIAO - DANCE WITH SOMEBODY
ALLE FARBEN - BAD IDEAS
B.O.B. FT HAILEY WILLIAMS - AIRPLANES
THE WEEKND - BLINDING LIGHTS
AVA MAX - TORN
CALVIN HARRIS - MY WAY
JOEL CORRY FT. MNEK - HEAD & HEART
JASON DERULO - TAKE YOU DANCING
THE EAGLES - HOTEL CALIFORNIA
TOM GREGORY - FINGERTIPS
WELSHLY ARMS - SANCTUARY
REA GARVEY - KISS ME
ED SHEERAN - LEGO HOUSE
ZOE WEES - GIRLS LIKE US
MARK RONSON FT. MILEY CYRUS - NOTHING BREAKS LIKE A HEART
SAM SMITH - DIAMONDS.
AVRIL LAVIGNE - COMPLICATED
RUDIMENTAL FT. JESS GLYNNE MACKLEMORE & DAN CAPLEN - THESE DAYS
ONE REPUBLIC - GOOD LIFE
AVA MAX - KINGS & QUEENS
ROBIN SCHULZ & WES - ALANE
SHEPPARD - GERONIMO
COLDPLAY FT BEYONCE - HYMN FOR THE WEEKEND
CH-PEGASUS - BETTER MAN
IMAGINE DRAGONS - BAD LIAR
ARGYLE SINGH - BY YOUR SIDE
LIAM PAYNE FT. A BOOGIE WIT DA HOODIE - STACK IT UP
PINK - WALK ME HOME
KYGO WITH AVICII & SANDRO CAVAZZA - FOREVER YOURS
WINCENT WEISS - AN WUNDER
CH-SEVEN - WALKING WITH YOU
DON HENLEY - BOYS OF SUMMER
VIZE & TOM GREGORY - NEVER LET ME DOWN
GEORGE EZRA - SHOTGUN
LAUREN DAIGLE - YOU SAY
ONE REPUBLIC - ALL THE RIGHT MOVES
RITA ORA - ANYWHERE
FUN FT JANELLE MONAE - WE ARE YOUNG
CAMILA CABELLO - HAVANA
ISRAEL KAMAKAWIWOOLE - OVER THE RAINBOW
CH-DAMIAN LYNN - BLINK OF AN EYE
DADDY YANKEE FT. SNOW - CON CALMA
FOOLS GARDEN FT. ALLE FARBEN - LEMON TREE
LEONA LEWIS - BETTER IN TIME
KYGO & SELENA GOMEZ - IT AIN'T ME
COLDPLAY - PARADISE.
PORTUGAL. THE MAN - LIVE IN THE MOMENT
KATY PERRY - HOT N COLD
ED SHEERAN FT. KHALID - BEAUTIFUL PEOPLE
DERMOT KENNEDY - GIANTS