

KYGO & ONE REPUBLIC - LOSE SOMEBODY
HARRY STYLES - ADORE YOU
HURTS - WONDERFUL LIFE
RIHANNA & KANYE WEST & PAUL MCCARTNEY - FOURFIVESECONDS
ED SHEERAN & JUSTIN BIEBER - I DON'T CARE
JAMES MORRISON FT NELLY FURTADO - BROKEN STRINGS
MILOW - FIRST DAY OF MY LIFE
DADDY YANKEE FT. SNOW - CON CALMA
JAMES ARTHUR - FALLING LIKE THE STARS
MILEY CYRUS - MIDNIGHT SKY
CH-GOTTHARD - HEAVEN.
CH-SEVEN - UNSER KLEINES WUNDER
PURPLE DISCO MACHINE & SOPHIE AND THE GIANTS - HYPNOTIZED
LEONY - FADED LOVE
GEORGE EZRA - SHOTGUN
CH-STEFANIE HEINZMANN FT. ALLE FARBEN - BUILD A HOUSE
LEWIS CAPALDI - BEFORE YOU GO
RAG'N'BONE MAN - ALL YOU EVER WANTED
ELLIE GOULDING - LIGHTS
SHAWN MENDES - TREAT YOU BETTER
CH-JOYA MARLEEN - NIGHTMARE
IMAGINE DRAGONS - FOLLOW YOU
CH-DAMIAN LYNN - BLINK OF AN EYE
COLDPLAY - HIGHER POWER
JAMES BLUNT - THE TRUTH
TOM GRENNAN - LITTLE BIT OF LOVE
CH-PATENT OCHSNER - FÃƒÅ“R IMMER UF DI
ED SHEERAN - AFTERGLOW
SHAKIRA - WHENEVER WHEREVER
ENRIQUE IGLESIAS - SUBEME LA RADIO
GLASPERLENSPIEL - GEILES LEBEN
LIAM PAYNE & RITA ORA - FOR YOU
BOB MARLEY - COULD YOU BE LOVED
IMAGINE DRAGONS - BIRDS
WINCENT WEISS - WER WENN NICHT WIR
COLBIE CAILLAT - BUBBLY
BASTILLE - GOOD GRIEF
KWABS - WALK
LOTTE & MAX GIESINGER - AUF DAS WAS DA NOCH KOMMT
KILLERS - HUMAN.
DOTAN - THERE WILL BE A WAY
TWOCOLORS - LOVEFOOL
CH-STEFANIE HEINZMANN - WOULD YOU STILL LOVE ME
ANASTACIA - I'M OUTTA LOVE
JUSTIN TIMBERLAKE FT. CHRIS STAPLETON - SAY SOMETHING
ADEL TAWIL - LIEDER
RAG'N'BONE MAN - HUMAN
JAMES ARTHUR - SAY YOU WON'T LET GO
AVA MAX - SALT
TOM GREGORY - RATHER BE YOU
DAVID GUETTA & SIA - FLOATING THROUGH SPACE
MICHAEL JACKSON - BEAT IT
THIRTY SECONDS TO MARS - WALK ON WATER
DUA LIPA - WE'RE GOOD
DEAN LEWIS - 7 MINUTES
UNCLE KRACKER - FOLLOW ME
CH-LUCA HÃ„NNI - SHE GOT ME
ADEL TAWIL - 1000 GUTE GRÜNDE
VIZE FT. TOKIO HOTEL - WHITE LIES
PINK - WHO KNEW
THE CHAINSMOKERS & COLDPLAY - SOMETHING JUST LIKE THIS
JUSTIN BIEBER - SORRY
RITA ORA - ANYWHERE
EAGLE-EYE CHERRY - SAVE TONIGHT
TOM GREGORY - RIVER
DENNIS LLOYD - ANXIOUS
HARRY STYLES - WATERMELON SUGAR
MEDUZA FT. DERMOT KENNEDY - PARADISE..
MARLON ROUDETTE - WHEN THE BEAT DROPS OUT
WALKING ON CARS - SPEEDING CARS