

IMAGINE DRAGONS - BIRDS
ONE DIRECTION - STORY OF MY LIFE
SHAWN MENDES - IF I CAN'T HAVE YOU
ROBIN SCHULZ FT. ALIDA - IN YOUR EYES.
TOM GREGORY - RATHER BE YOU
MARQUESS - VAYAMOS COMPANEROS
ZOE WEES - GIRLS LIKE US
GEORGE EZRA - SHOTGUN
JONAS BROTHERS - ONLY HUMAN
PINK - TODAY'S THE DAY
RED HOT CHILI PEPPERS - SNOW
DENNIS LLOYD - ANXIOUS
LP - GIRLS GO WILD
CHARLIE PUTH - ONE CALL AWAY
JULI - PERFEKTE WELLE
SHAWN MENDES - THERE'S NOTHING HOLDIN' ME BACK
BRUNO MARS - JUST THE WAY YOU ARE
JASON MRAZ - I'M YOURS
DOTAN - THERE WILL BE A WAY
ED SHEERAN & JUSTIN BIEBER - I DON'T CARE
ONE REPUBLIC - RESCUE ME
MR BIG - TO BE WITH YOU
RUDIMENTAL FT. JESS GLYNNE MACKLEMORE & DAN CAPLEN - THESE DAYS
LUIS FONSI & DEMI LOVATO - ECHAME LA CULPA
MAROON 5 - GIRLS LIKE YOU
WALKING ON CARS - SPEEDING CARS
ROBBIE WILLIAMS - SHE'S THE ONE
CH-BASTIAN BAKER - I'D SING FOR YOU
KYGO & SELENA GOMEZ - IT AIN'T ME
JAMES MORRISON FT NELLY FURTADO - BROKEN STRINGS
ROBIN SCHULZ FT. KIDDO - ALL WE GOT
DEAN LEWIS - 7 MINUTES
ALVARO SOLER FT. JENNIFER LOPEZ - EL MISMO SOL
SHAKIRA - HIPS DON'T LIE
GUNS N ROSES - KNOCKIN' ON HEAVEN'S DOOR
THE KID LAROI - WITHOUT YOU.
OFENBACH FT. LAGIQUE - WASTED LOVE
MIMI WEBB - GOOD WITHOUT
ZOE WEES - CONTROL
TOM GREGORY - RIVER
MADCON - BEGGIN
CH-LOCO ESCRITO - AMAME
RAY DALTON - GOOD TIMES HARD TIMES
JAMES BLUNT - COLD
HARRY STYLES - ADORE YOU
CH-ZIAN - GRATEFUL
HALSEY - YOU SHOULD BE SAD
OLIVIA RODRIGO - GOOD 4 U
COLDPLAY - CLOCKS
DERMOT KENNEDY - POWER OVER ME
JOHN LEGEND - ALL OF ME
FLO RIDA - WHISTLE