

ALLE FARBEN & CH-ILIRA - FADING
LEONA LEWIS - BLEEDING LOVE
SWEDISH HOUSE MAFIA - DON'T YOU WORRY CHILD
ALVARO SOLER - LA CINTURA
PINK FT. CASH CASH - CAN WE PRETEND
DAVID GUETTA & SIA - FLOATING THROUGH SPACE
DOTAN - NUMB
WELSHLY ARMS - LEGENDARY
ED SHEERAN - BAD HABITS
ADEL TAWIL - 1000 GUTE GRÃœNDE
SUNRISE AVENUE - HOLLYWOOD HILLS
THORSTEINN EINARSSON - SHACKLES
R. CITY FT ADAM LEVINE - LOCKED AWAY
MACY GRAY - I TRY
ANDREAS BOURANI - AUF UNS
ELLIE GOULDING - LOVE ME LIKE YOU DO
LEONY - FADED LOVE
PINK - WALK ME HOME
CH-ZIAN - GRATEFUL
SIDO - TAUSEND TATTOOS
JAMES BLUNT - THE TRUTH
CH-STEFANIE HEINZMANN FT. ALLE FARBEN - BUILD A HOUSE
ED SHEERAN - THINKING OUT LOUD
RITA ORA - ANYWHERE
MARTIN GARRIX FT. BONO & THE EDGE - WE ARE THE PEOPLE.
CH-JOYA MARLEEN - NIGHTMARE
DUNCAN LAURENCE - ARCADE
LADY GAGA - STUPID LOVE
LENNY KRAVITZ - I'LL BE WAITING
JASON DERULO FT. NUKA - LOVE NOT WAR
AVA MAX - SALT
FREYA RIDINGS - CASTLES
BRYAN ADAMS - EVERYTHING I DO I DO IT FOR YOU
BASTILLE - GOOD GRIEF
CH-KUNZ - LÜÜT SO WIE MER
VIZE & TOM GREGORY - NEVER LET ME DOWN
CH-CRIMER - EYES OFF ME
ALICIA KEYS - GIRL ON FIRE
JUSTIN WELLINGTON FT. SMALL JAM - IKO IKO
ROXETTE - LISTEN TO YOUR HEART
LADY GAGA - ALWAYS REMEMBER US THIS WAY
CH-PEGASUS - BETTER MAN
JASON DERULO - TAKE YOU DANCING
JONAS BROTHERS - WHAT A MAN GOTTA DO
MIMI WEBB - GOOD WITHOUT
LABRINTH FT EMELI SANDE - BENEATH YOUR BEAUTIFUL
AVA MAX - TORN
TOPIC FT. A7S - BREAKING ME
TAYLOR SWIFT - BLANK SPACE