

PINK FT. WILLOW SAGE HART - COVER ME IN SUNSHINE
LEONY - FADED LOVE
EMELI SANDE - READ ALL ABOUT IT (PT. III)
PANIC! AT THE DISCO - HIGH HOPES.
ALAN WALKER - ALONE
ADEL TAWIL FT. PEACHY - TU M'APPELLES
CH-JOYA MARLEEN - NIGHTMARE
YOUNOTUS & JULIAN PERRETTA - YOUR FAVOURITE SONG
AVA MAX - MY HEAD & MY HEART
JAMES BLUNT - THE TRUTH
DECLAN J. DONOVAN - PIECES
LOST FREQUENCIES & ZONDERLING - CRAZY
MARK RONSON FT. MILEY CYRUS - NOTHING BREAKS LIKE A HEART
DENNIS LLOYD - ANXIOUS
COLDPLAY - PARADISE.
MAROON 5 - GIRLS LIKE YOU
MICHAEL PATRICK KELLY - BEAUTIFUL MADNESS
DEAN LEWIS - BE ALRIGHT
MILOW - FIRST DAY OF MY LIFE
DAVID GUETTA FT KELLY ROWLAND - WHEN LOVE TAKES OVER
SUNRISE AVENUE - I HELP YOU HATE ME
LEWIS CAPALDI - BEFORE YOU GO
ADELE - SET FIRE TO THE RAIN
TONES AND I - DANCE MONKEY
PASSENGER - ANYWHERE.
DOTAN - NUMB
MADONNA - LIKE A PRAYER
NATHAN EVANS - WELLERMAN (SEA SHANTY)
CH-LO & LEDUC - JUNG VERDAMMT
JAMES BLUNT - COLD
HARRY STYLES - SIGN OF THE TIMES
KYGO FT. SANDRO CAVAZZA - HAPPY NOW.
IMAGINE DRAGONS - BAD LIAR
RIHANNA FT JAY-Z - UMBRELLA
CH-BASTIAN BAKER - DANCING WITHOUT YOU