

LEWIS CAPALDI - BEFORE YOU GO
ED SHEERAN - AFTERGLOW
YOUNOTUS & JULIAN PERRETTA - YOUR FAVOURITE SONG
KYGO FT. TINA TURNER - WHAT'S LOVE GOT TO DO WITH IT
AMY WINEHOUSE - BACK TO BLACK
LOST FREQUENCIES - ARE YOU WITH ME
SIA - UNSTOPPABLE
JAMES BLUNT - THE TRUTH
DON HENLEY - BOYS OF SUMMER
AVICII FT. ALOE BLACC - SOS
RIHANNA FT MIKKY EKKO - STAY.
TOM WALKER - LEAVE A LIGHT ON
EAGLE-EYE CHERRY - SAVE TONIGHT
SUNRISE AVENUE - HOLLYWOOD HILLS
SIDO FT. ANDREAS BOURANI - ASTRONAUT
JUSTIN JESSO - GETTING CLOSER
HURTS - WONDERFUL LIFE
CH-PEGASUS - GET OVER YOU
JONAS BROTHERS - WHAT A MAN GOTTA DO
ED SHEERAN - DON'T
PHIL COLLINS - ANOTHER DAY IN PARADISE
AVA MAX - WHO'S LAUGHING NOW
MILOW - FIRST DAY OF MY LIFE
CH-STEFANIE HEINZMANN - SHADOWS
SAM SMITH - DIAMONDS.
POST MALONE - CIRCLES
BRYAN ADAMS - SUMMER OF 69
REA GARVEY - TALK TO YOUR BODY
JAMES ARTHUR - FALLING LIKE THE STARS
FREYA RIDINGS - CASTLES
3 DOORS DOWN - HERE WITHOUT YOU
CLEAN BANDIT FT. ZARA LARSSON - SYMPHONY
LINKIN PARK - BURN IT DOWN
LADY GAGA - ALWAYS REMEMBER US THIS WAY
CH-LOCO ESCRITO - ADIÃ½S
ED SHEERAN FT. FELIX JAEHN - PHOTOGRAPH
SHAWN MENDES - MERCY
SNOW PATROL - CHASING CARS
DUA LIPA - PHYSICAL
CH-JOYA MARLEEN - NIGHTMARE
OLIVIA RODRIGO - DRIVERS LICENSE
MICHAEL JACKSON - BILLIE JEAN
IMAGINE DRAGONS - WHATEVER IT TAKES
JOEL CORRY FT. MNEK - HEAD & HEART
JOHANNES OERDING - AN GUTEN TAGEN
EVANESCENCE - BRING ME TO LIFE
AVA MAX - KINGS & QUEENS
MAROON 5 - GIRLS LIKE YOU
JC STEWART - BREAK MY HEART
ISRAEL KAMAKAWIWOOLE - OVER THE RAINBOW