

BOB MARLEY - ONE LOVE/PEOPLE GET READY
JONAS BROTHERS - WHAT A MAN GOTTA DO
CH-LUCA HÃƒÆ’Ã‚Â½NNI - SHE GOT ME
MAROON 5 - GIRLS LIKE YOU
MARK FORSTER - ÃƒÂ½BERMORGEN
JAMES BAY - CHEW ON MY HEART
ELLIE GOULDING - LIGHTS
THE WEEKND - IN YOUR EYES
ZOE WEES - CONTROL
JOEL CORRY FT. MNEK - HEAD & HEART
CH-LO & LEDUC - TRIBUT
KYGO FT. TINA TURNER - WHAT'S LOVE GOT TO DO WITH IT
CH-JOYA MARLEEN - NIGHTMARE
DERMOT KENNEDY - GIANTS
GAVIN JAMES - ALWAYS
JONAS BROTHERS - SUCKER
MILEY CYRUS - MIDNIGHT SKY
ED SHEERAN - THE A TEAM
NICO SANTOS - ROOFTOP
TOM GREGORY - SMALL STEPS
JASON DERULO - TAKE YOU DANCING
AVA MAX - TORN
CH-KUNZ - MUSIG
MILOW - WHATEVER IT TAKES.
KYGO FT. DONNA SUMMER - HOT STUFF
DEAN LEWIS - BE ALRIGHT
CLEAN BANDIT AND MABEL FT. 24GOLDN - TICK TOCK
BENJI & FEDE - DOVE E QUANDO
MICHAEL PATRICK KELLY - BEAUTIFUL MADNESS
MASTER KG FT. BURNA BOY & NOMCEBO ZIKODE - JERUSALEMA
REGARD - RIDE IT
TOM GREGORY - FINGERTIPS
RAY DALTON - GOOD TIMES HARD TIMES
IMAGINE DRAGONS - BAD LIAR
DAVID GUETTA & SIA - LET'S LOVE
BON JOVI - IT'S MY LIFE
LINKIN PARK AND KIIARA - HEAVY
DAFT PUNK FT PHARRELL WILLIAMS - GET LUCKY
CH-BLIGG FT. MARC SWAY - US MÃ½NSCH
DANIEL POWTER - BAD DAY
MARK RONSON FT. MILEY CYRUS - NOTHING BREAKS LIKE A HEART
PINK FT. CASH CASH - CAN WE PRETEND
ARGYLE SINGH - BY YOUR SIDE
RIHANNA FT JAY-Z - UMBRELLA
THE STRUMBELLAS - SPIRITS
JESSIE J FT B.O.B. - PRICE TAG
JASON MRAZ - HAVE IT ALL
TINA TURNER - THE BEST
ED SHEERAN FT. KHALID - BEAUTIFUL PEOPLE
NEA - SOME SAY
CH-DAMIAN LYNN - 2020 FUCKED ME UP
GEORGE MICHAEL - FAITH
ROBIN SCHULZ & J.U.D.G.E. - SHOW ME LOVE
AVA MAX - WHO'S LAUGHING NOW
NOAH KAHAN FT. JULIA MICHAELS - HURT SOMEBODY
JUSTIN TIMBERLAKE - WHAT GOES AROUND... COMES AROUND
PINK - WALK ME HOME
LADY GAGA & BRADLEY COOPER - SHALLOW
CH-LOCO ESCRITO - TRISTE
KATY PERRY - HOT N COLD
CH-KUNZ - CHLIINI HýND