

CH-GOTTHARD - X-MAS MERRY X-MAS
AVA MAX - KINGS & QUEENS
MICHAEL BUBLE - X-MAS ALL I WANT FOR CHRISTMAS
IMAGINE DRAGONS - NATURAL
LEONA LEWIS - X-MAS ONE MORE SLEEP
RAY DALTON - IN MY BONES
ALVARO SOLER - LA CINTURA
BON JOVI - X-MAS PLEASE COME HOME FOR CHRISTMAS
TOM WALKER - JUST YOU AND I
QUEEN - X-MAS THANK GOD IT'S CHRISTMAS
CH-STEFANIE HEINZMANN FT. ALLE FARBEN - BUILD A HOUSE
JOSE FELICIANO - X-MAS FELIZ NAVIDAD
SHEPPARD - COMING HOME
GLASPERLENSPIEL - GEILES LEBEN
SHAWN MENDES - IN MY BLOOD
SHAKIN STEVENS - X-MAS MERRY CHRISTMAS EVERYONE
GALANTIS FT. ONE REPUBLIC - BONES
LAUREN DAIGLE - YOU SAY
DECLAN J. DONOVAN - PIECES
MARIAH CAREY - X-MAS CHRISTMAS
MAX GIESINGER - LEGENDEN
LOREEN - EUPHORIA
LIAM PAYNE & RITA ORA - FOR YOU
WHAM - X-MAS LAST CHRISTMAS
CH-STEFANIE HEINZMANN FT. JAKE ISAAC - ALL WE NEED IS LOVE
JAMES BAY - CHEW ON MY HEART
VIZE & TOM GREGORY - NEVER LET ME DOWN
DOTAN - NUMB
AVA MAX - WHO'S LAUGHING NOW
BON JOVI - X-MAS EVERYDAY COULD BE LIKE X-MAS
REA GARVEY - KISS ME
KYGO FT. DONNA SUMMER - HOT STUFF
CH-LUCA HÃ½NNI - SHE GOT ME
JOEL CORRY FT. MNEK - HEAD & HEART
LEONA LEWIS - BETTER IN TIME
SHAWN MENDES - THERE'S NOTHING HOLDIN' ME BACK
MELANIE THORNTON - X-MAS WONDERFUL DREAM (HOLIDAYS ARE COMING)
LP - GIRLS GO WILD
ROBBIE WILLIAMS - SUPREME
PINK - WALK ME HOME
GEORGE EZRA - PARADISE
CH-KUNZ - MUSIG
REM - LOSING MY RELIGION
KYGO & SELENA GOMEZ - IT AIN'T ME
BRYAN ADAMS - X-MAS CHRISTMAS TIME
SIA - THE GREATEST
LIMP BIZKIT - BEHIND BLUE EYES
WINCENT WEISS - HIER MIT DIR
JONAS BROTHERS FT. KAROL G - X
CH-DAMIAN LYNN - 2020 FUCKED ME UP
PAUL MCCARTNEY - X-MAS WONDERFUL CHRISTMAS TIME
THE STRUMBELLAS - SPIRITS
ARIANA GRANDE - X-MAS SANTA TELL ME
CH-77 BOMBAY STREET - EMPIRE
ICH + ICH - SO SOLL ES BLEIBEN
REGARD - RIDE IT
KYGO & ONE REPUBLIC - LOSE SOMEBODY
THE WEEKND - SAVE YOUR TEARS
CRAZY TOWN - BUTTERFLY