

THE EAGLES - HOTEL CALIFORNIA
DUA LIPA - PHYSICAL
CH-JOYA MARLEEN - NIGHTMARE
JAMES BLUNT - COLD
EROS RAMAZZOTTI FT. TINA TURNER - COSE DELLA VITA
LADY GAGA - ALWAYS REMEMBER US THIS WAY
GEORGE EZRA - SHOTGUN
EVANESCENCE - BRING ME TO LIFE
HURTS - WONDERFUL LIFE
MEDUZA FT. DERMOT KENNEDY - PARADISE..
DECLAN J. DONOVAN - PIECES
OUTKAST - HEY YA
ED SHEERAN - AFTERGLOW
YOUNOTUS & JANIECK & SENEX - NARCOTIC
JOHANNES OERDING - AN GUTEN TAGEN
NICO SANTOS - PLAY WITH FIRE
ZOE WEES - GIRLS LIKE US
ONE REPUBLIC - GOOD LIFE
CH-STEFANIE HEINZMANN - SHADOWS
DENNIS LLOYD - ANXIOUS
CH-DAMIAN LYNN - BLINK OF AN EYE
TOM GRENNAN - LITTLE BIT OF LOVE
DERMOT KENNEDY - OUTNUMBERED
PURPLE DISCO MACHINE & SOPHIE AND THE GIANTS - HYPNOTIZED
COLDPLAY FT BEYONCE - HYMN FOR THE WEEKEND
THE KID LAROI - WITHOUT YOU.
THE VERVE - BITTER SWEET SYMPHONY
ELLIE GOULDING - LOVE ME LIKE YOU DO
SHEPPARD - GERONIMO
LIAM PAYNE & RITA ORA - FOR YOU
ED SHEERAN & JUSTIN BIEBER - I DON'T CARE
CH-PEGASUS - BETTER MAN
DAVID GUETTA & SIA - LET'S LOVE
RAY DALTON - IN MY BONES
LINKIN PARK - WHAT I'VE DONE
ENRIQUE IGLESIAS - SUBEME LA RADIO
ALEX MAX BAND - TONIGHT
ANNE-MARIE - 2002
PUFF DADDY FT FAITH EVANS - I'LL BE MISSING YOU
CH-BASTIAN BAKER - DANCING WITHOUT YOU