

DERMOT KENNEDY - POWER OVER ME
ROBIN SCHULZ FT. KIDDO - ALL WE GOT
PHARRELL WILLIAMS - HAPPY.
CH-LOCO ESCRITO - PUNTO
GEORGE EZRA - PARADISE
MARK FORSTER - Ã½BERMORGEN
OFENBACH & QUARTERHEAD FT. NORMA JEAN MARTINE - HEAD SHOULDERS KNEES & TOES
ECHOSMITH - COOL KIDS
NICKELBACK - SONG ON FIRE
DADDY YANKEE FT. SNOW - CON CALMA
KELLY CLARKSON - BECAUSE OF YOU
OLLY MURS FT DEMI LOVATO - UP
DECLAN J. DONOVAN - PIECES
ROBIN SCHULZ FT. ALIDA - IN YOUR EYES.
COOLIO - GANGSTA'S PARADISE
DERMOT KENNEDY - OUTNUMBERED
CH-PEGASUS - GET OVER YOU
EMELI SANDE - READ ALL ABOUT IT (PT. III)
SIA - THE GREATEST
COLDPLAY - CLOCKS
ALICIA KEYS - UNDERDOG
NEA - SOME SAY
FERGIE - BIG GIRLS DON'T CRY
RAY DALTON - IN MY BONES
MATT SIMONS - CATCH & RELEASE (DEEPEND REMIX)
LINKIN PARK - BURNING IN THE SKIES
JONAS BROTHERS FT. KAROL G - X
JAMES MORRISON FT NELLY FURTADO - BROKEN STRINGS
REA GARVEY - TALK TO YOUR BODY
SUNRISE AVENUE - HOLLYWOOD HILLS
CAMILA CABELLO - HAVANA
SNOW PATROL - CHASING CARS
SIA - UNSTOPPABLE
LADY GAGA - ALWAYS REMEMBER US THIS WAY
DENNIS LLOYD - ANXIOUS
THE WEEKND - IN YOUR EYES
MILOW - WHATEVER IT TAKES.
PURPLE DISCO MACHINE & SOPHIE AND THE GIANTS - HYPNOTIZED
CH-LUCA HýNNI - SHE GOT ME
THE KID LAROI - WITHOUT YOU.
MELANIE FIONA - GIVE IT TO ME RIGHT
LEWIS CAPALDI - BEFORE YOU GO
DOTAN - THERE WILL BE A WAY
CLEAN BANDIT AND MABEL FT. 24GOLDN - TICK TOCK
KYGO & ONE REPUBLIC - LOSE SOMEBODY
CH-PEGASUS - BETTER MAN
SPIN DOCTORS - TWO PRINCES
MAROON 5 - MEMORIES
TONES AND I - DANCE MONKEY
MICHAEL PATRICK KELLY - BEAUTIFUL MADNESS
ALLE FARBEN & CH-ILIRA - FADING
MILEY CYRUS FT. DUA LIPA - PRISONER
CH-KUNZ - MUSIG
DERMOT KENNEDY - GIANTS
THE WEEKND - SAVE YOUR TEARS
DIDDY DIRTY MONEY FT. SKYLAR GREY - COMING HOME.
KYGO FT. TINA TURNER - WHAT'S LOVE GOT TO DO WITH IT
CH-STEFANIE HEINZMANN - SHADOWS
BTS - DYNAMITE
AVA MAX - MY HEAD & MY HEART
DEAN LEWIS - 7 MINUTES
JASON DERULO - WANT TO WANT ME
REAMONN - TONIGHT.
IMAGINE DRAGONS - BAD LIAR
DAVID GUETTA & SIA - LET'S LOVE
JUSTIN BIEBER - LOVE YOURSELF
CALVIN HARRIS FT JOHN NEWMAN - BLAME
CH-BLAY - DENKMAL
JASON MRAZ - I'M YOURS
MABEL - DON'T CALL ME UP
CH-ZIAN - SHOW YOU
MARSHMELLO FT. BASTILLE - HAPPIER.
ALANIS MORISSETTE - IRONIC
CH-CRIMER - EYES OFF ME
PINK FT. WILLOW SAGE HART - COVER ME IN SUNSHINE
LOST FREQUENCIES FT. NGHBRS - LIKE I LOVE YOU
LEONA LEWIS - BETTER IN TIME