
SHAWN MENDES - STITCHES
JASON DERULO FT. NUKA - LOVE NOT WAR
GEORGE EZRA - BLAME IT ON ME
MARK FORSTER - ÃƒÆ’Ã…â€œBERMORGEN
MARK FORSTER - ÃƒÅ“BERMORGEN
ED SHEERAN FT. CAMILA CABELLO - SOUTH OF THE BORDER
TOPIC FT. A7S - BREAKING ME
SAM SMITH - DIAMONDS.
CH-JOYA MARLEEN - NIGHTMARE
WINCENT WEISS - WER WENN NICHT WIR
OLLY MURS FT. RIZZLE KICKS - HEART SKIPS A BEAT
CLEAN BANDIT AND MABEL FT. 24GOLDN - TICK TOCK
BON JOVI - YOU GIVE LOVE A BAD NAME
JAMES BLUNT - THE TRUTH
CH-ZIAN - SHOW YOU
TRAIN - DRIVE BY
BENJI & FEDE - DOVE E QUANDO
NICO SANTOS - PLAY WITH FIRE
REAMONN - TONIGHT.
PINK FT. WILLOW SAGE HART - COVER ME IN SUNSHINE
CH-BLIGG - B.L.I. DOPPEL G
AVICII - HEY BROTHER
THE FAIM - SUMMER IS A CURSE
DUA LIPA - WE'RE GOOD
GURU JOSH PROJECT - INFINITY 08
CH-PEGASUS & ANNA ROSSINELLI - VICTORIA LINE
ALVARO SOLER - MAGIA
CH-KUNZ - LÃœÃœT SO WIE MER
CH-KUNZ - LÜÜT SO WIE MER
TWOCOLORS - LOVEFOOL
PURPLE DISCO MACHINE & SOPHIE AND THE GIANTS - HYPNOTIZED
MILEY CYRUS - MALIBU
QUEEN - RADIO GA GA
DOTAN - THERE WILL BE A WAY
KODALINE - BROTHER
LADY GAGA - ALWAYS REMEMBER US THIS WAY
KATY PERRY - ROAR
ZOE WEES - CONTROL
ALLE FARBEN & CH-ILIRA - FADING
SHEPPARD - SYMPHONY.
CALVIN HARRIS FT JOHN NEWMAN - BLAME
JAMES BLUNT - COLD
EVANESCENCE - BRING ME TO LIFE
MAROON 5 - MEMORIES
MARLON ROUDETTE - WHEN THE BEAT DROPS OUT
ARGYLE SINGH - BY YOUR SIDE
LEWIS CAPALDI - BEFORE YOU GO
CONAN GRAY - OVERDRIVE
DERMOT KENNEDY - GIANTS
NELLY FURTADO - TRY
MARK RONSON FT. MILEY CYRUS - NOTHING BREAKS LIKE A HEART
MAX GIESINGER - 80 MILLIONEN
TOPIC FT. A7S & ATB - YOUR LOVE (9PM)
DIDDY DIRTY MONEY FT. SKYLAR GREY - COMING HOME.
ALVARO SOLER - LA CINTURA
KALEO - WAY DOWN WE GO