

TOM GREGORY - SMALL STEPS
MILEY CYRUS - MIDNIGHT SKY
SWEDISH HOUSE MAFIA - DON'T YOU WORRY CHILD
JUSTIN TIMBERLAKE FT. CHRIS STAPLETON - SAY SOMETHING
DERMOT KENNEDY - GIANTS
BON JOVI - YOU GIVE LOVE A BAD NAME
LIAM PAYNE & RITA ORA - FOR YOU
YOUNOTUS & JANIECK & SENEX - NARCOTIC
ALLE FARBEN & CH-ILIRA - FADING
JONAS BROTHERS - SUCKER
REA GARVEY - TALK TO YOUR BODY
ARGYLE SINGH - BY YOUR SIDE
TOPIC FT. A7S - BREAKING ME
CH-BASTIAN BAKER - DANCING WITHOUT YOU
TOM GREGORY - FINGERTIPS
KYGO FT. DONNA SUMMER - HOT STUFF
LADY GAGA - ALWAYS REMEMBER US THIS WAY
SAM SMITH - DIAMONDS.
DIE TOTEN HOSEN - TAGE WIE DIESE
WALKING ON CARS - SPEEDING CARS
MICHAEL JACKSON - THRILLER
ED SHEERAN - HAPPIER
COLDPLAY - PARADISE.
ALEC BENJAMIN - LET ME DOWN SLOWLY
GURU JOSH PROJECT - INFINITY 08
HALSEY - YOU SHOULD BE SAD
ALEX MAX BAND - TONIGHT
WINCENT WEISS - MUSIK SEIN
GREEN DAY - WAKE ME UP WHEN SEPTEMBER ENDS
ALLE FARBEN - BAD IDEAS
IMAGINE DRAGONS - ON TOP OF THE WORLD
ROBIN SCHULZ & WES - ALANE
CH-BLIGG - MANHATTAN
REGARD - RIDE IT
SUNRISE AVENUE - HOLLYWOOD HILLS
RUDIMENTAL FT. JAMES ARTHUR - SUN COMES UP
MANDO DIAO - DANCE WITH SOMEBODY
CH-PEGASUS - GET OVER YOU
LINKIN PARK - BURN IT DOWN
LIAM PAYNE FT. A BOOGIE WIT DA HOODIE - STACK IT UP
FERGIE - BIG GIRLS DON'T CRY
JONAS BROTHERS - WHAT A MAN GOTTA DO
SHAWN MENDES & CAMILA CABELLO - SENORITA
THE KID LAROI - WITHOUT YOU.
COOLIO - GANGSTA'S PARADISE
MAX GIESINGER - LEGENDEN
BRUNO MARS - JUST THE WAY YOU ARE
EMINEM FT. ED SHEERAN - RIVER
WILL SMITH - MIAMI
POST MALONE - CIRCLES
DOTAN - NUMB
JC STEWART - BREAK MY HEART
AVRIL LAVIGNE - COMPLICATED
CLEAN BANDIT FT. ZARA LARSSON - SYMPHONY
MILOW - FIRST DAY OF MY LIFE
ALVARO SOLER - LA CINTURA
HOOBASTANK - THE REASON
YOUNOTUS & JULIAN PERRETTA - YOUR FAVOURITE SONG
WINCENT WEISS - HIER MIT DIR
OLIVIA RODRIGO - DRIVERS LICENSE
MICHAEL JACKSON - BILLIE JEAN
CH-77 BOMBAY STREET - EMPIRE
TAYLOR SWIFT - BLANK SPACE
SHEPPARD - COMING HOME
TOPLOADER - DANCING IN THE MOONLIGHT
JONAS BROTHERS FT. KAROL G - X
CH-LO & LEDUC - TRIBUT
GEORGE EZRA - SHOTGUN