

TWOCOLORS - LOVEFOOL
JASON MRAZ - I'M YOURS
LADY GAGA - BORN THIS WAY
JUSTIN JESSO - GETTING CLOSER
CH-BASTIAN BAKER - DANCING WITHOUT YOU
AURA DIONE - I WILL LOVE YOU MONDAY
MUMFORD & SONS - I WILL WAIT
CH-STEFANIE HEINZMANN - COLORS
TOPIC FT. A7S - BREAKING ME
NELLY FURTADO - TRY.
OFENBACH & QUARTERHEAD FT. NORMA JEAN MARTINE - HEAD SHOULDERS KNEES & TOES
ED SHEERAN - THE A TEAM
THE WEEKND - BLINDING LIGHTS
JASON DERULO FT. NUKA - LOVE NOT WAR
WINCENT WEISS - WER WENN NICHT WIR
SHEPPARD - SYMPHONY.
CH-ZIAN - GRATEFUL
AVA MAX - TORN
PURPLE DISCO MACHINE & SOPHIE AND THE GIANTS - HYPNOTIZED
MIMI WEBB - GOOD WITHOUT
RAG'N'BONE MAN - ALL YOU EVER WANTED
SIDO - BILDER IM KOPF
TOTO - ROSANNA
JAMES BLUNT - COLD
ZOE WEES - GIRLS LIKE US
DAVID GUETTA FT KELLY ROWLAND - WHEN LOVE TAKES OVER
CH-PEGASUS - GET OVER YOU
SIA - CHANDELIER
HARRY STYLES - WATERMELON SUGAR
NICKELBACK - HOW YOU REMIND ME
JUSTIN WELLINGTON FT. SMALL JAM - IKO IKO
THE WEEKND - IN YOUR EYES
CH-ZIAN - SHOW YOU
MELANIE FIONA - GIVE IT TO ME RIGHT
ALAN WALKER - FADED
JAMES ARTHUR - IMPOSSIBLE
JAMES BLUNT - THE TRUTH
ED SHEERAN FT. CAMILA CABELLO - SOUTH OF THE BORDER
ADELE - SET FIRE TO THE RAIN
MAX GIESINGER - WENN SIE TANZT
DUA LIPA - WE'RE GOOD
KYGO FT. TINA TURNER - WHAT'S LOVE GOT TO DO WITH IT
PINK - WALK ME HOME
NATHAN EVANS - TOLD YOU SO
CH-LO & LEDUC - JUNG VERDAMMT
MICHAEL PATRICK KELLY - THROWBACK
RAY DALTON - GOOD TIMES HARD TIMES
CH-PEGASUS - BETTER MAN
OFENBACH FT. LAGIQUE - WASTED LOVE
COLDPLAY - HIGHER POWER
OF MONSTERS AND MEN - LITTLE TALKS
ADEL TAWIL - DIE WELT STEHT AUF PAUSE
WIZ KAHLIFA FT CHARLIE PUTH - SEE YOU AGAIN
ANASTACIA - PAID MY DUES
BASTILLE - GOOD GRIEF
RIHANNA - DIAMONDS
CH-CRIMER - EYES OFF ME