

PURPLE DISCO MACHINE & SOPHIE AND THE GIANTS - HYPNOTIZED
OFENBACH FT. LAGIQUE - WASTED LOVE
PRINCE - PURPLE RAIN
ROBIN SCHULZ & J.U.D.G.E. - SHOW ME LOVE
ROBIN THICKE FT T.I. + PHARRELL - BLURRED LINES
WINCENT WEISS - AN WUNDER
MARLON ROUDETTE - WHEN THE BEAT DROPS OUT
DADDY YANKEE FT. SNOW - CON CALMA
CH-JOYA MARLEEN - NIGHTMARE
JASON DERULO - TAKE YOU DANCING
RAG'N'BONE MAN - ALL YOU EVER WANTED
JAMES ARTHUR - IMPOSSIBLE
COLDPLAY - HIGHER POWER
LAUREN DAIGLE - YOU SAY
ALLE FARBEN & CH-ILIRA - FADING
DENNIS LLOYD - ANXIOUS
MASTER KG FT. BURNA BOY & NOMCEBO ZIKODE - JERUSALEMA
LADY GAGA - POKER FACE
SHAWN MENDES - IF I CAN'T HAVE YOU
THE KID LAROI - WITHOUT YOU.
KYGO & WHITNEY HOUSTON - HIGHER LOVE
REAMONN - SUPERGIRL
KUNGS VS. COOKIN' ON 3 BURNERS - THIS GIRL
SHAKIRA - HIPS DON'T LIE
DECLAN J. DONOVAN - PIECES
JASON DERULO FT. NUKA - LOVE NOT WAR
MILOW - FIRST DAY OF MY LIFE
TOPIC FT. A7S - BREAKING ME
WINCENT WEISS - WER WENN NICHT WIR
VIZE & TOM GREGORY - NEVER LET ME DOWN
CH-STEFANIE HEINZMANN FT. JAKE ISAAC - ALL WE NEED IS LOVE
MAROON 5 FT. MEGAN THEE STALLION - BEAUTIFUL MISTAKES
ECHOSMITH - COOL KIDS
HARRY STYLES - WATERMELON SUGAR
ELLIE GOULDING - LOVE ME LIKE YOU DO
JULI - PERFEKTE WELLE
UGLY KID JOE - CATS IN THE CRADLE
CH-BASTIAN BAKER - DANCING WITHOUT YOU
DUA LIPA - DON'T START NOW
ONE REPUBLIC - RUN.
GLASPERLENSPIEL - GEILES LEBEN
TOM GRENNAN - LITTLE BIT OF LOVE
NATALIE IMBRUGLIA - TORN
TONES AND I - DANCE MONKEY
ED SHEERAN & JUSTIN BIEBER - I DON'T CARE
THE WEEKND - BLINDING LIGHTS
BOB MARLEY - COULD YOU BE LOVED
OLIVIA RODRIGO - GOOD 4 U
LOST FREQUENCIES FT. NGHBRS - LIKE I LOVE YOU
IMAGINE DRAGONS - FOLLOW YOU
4 NON BLONDES - WHAT'S UP
AVICII FT. CHRIS MARTIN - HEAVEN
NICO SANTOS - PLAY WITH FIRE
SHAWN MENDES - TREAT YOU BETTER