

THE KID LAROI - WITHOUT YOU.
WINCENT WEISS - WER WENN NICHT WIR
MATTAFIX - BIG CITY LIFE
SHAWN MENDES - TREAT YOU BETTER
SIMPLE PLAN FT SEAN PAUL - SUMMER PARADISE
LADY GAGA - MILLION REASONS
KERI HILSON - I LIKE
LEONY - FADED LOVE
DERMOT KENNEDY - OUTNUMBERED
AVA MAX - EVERYTIME I CRY
BRUNO MARS - THE LAZY SONG
TOM GREGORY - RIVER
CH-ZIAN - SHOW YOU
JAMES BLUNT - COLD
MICHAEL PATRICK KELLY - THROWBACK
LEWIS CAPALDI - SOMEONE YOU LOVED
COLDPLAY - HIGHER POWER
EMINEM FT RIHANNA - LOVE THE WAY YOU LIE
PANIC! AT THE DISCO - HIGH HOPES.
TINA TURNER - THE BEST
JUSTIN BIEBER - SORRY
SHAKIRA FT FRESHLYGROUND - WAKA WAKA (THIS TIME FOR AFRIKA)
POST MALONE - CIRCLES
LOST FREQUENCIES FT JANIECK DEVY - REALITY
TAKE THAT - PATIENCE
MARLON ROUDETTE - NEW AGE
TOM GREGORY - SMALL STEPS
TWOCOLORS - LOVEFOOL
ZOE WEES - HOLD ME LIKE YOU USED TO
PASSENGER - LET HER GO
ED SHEERAN - BAD HABITS