

JAMES BLUNT - THE TRUTH
SAM SMITH - DIAMONDS.
GEORGE EZRA - BLAME IT ON ME
CH-KUNZ - CHLIINI HÃ½ND
CH-MARIUS BEAR - I WANNA DANCE WITH SOMEBODY
MEDUZA FT. DERMOT KENNEDY - PARADISE..
ED SHEERAN - THE A TEAM
JUSTIN TIMBERLAKE - CAN'T STOP THE FEELING!
SHAKIRA FT. ALEJANDRO SANZ - LA TORTURA
LINKIN PARK - BURN IT DOWN
LIAM PAYNE FT. A BOOGIE WIT DA HOODIE - STACK IT UP
DEAN LEWIS - BE ALRIGHT
ROBIN SCHULZ FT. KIDDO - ALL WE GOT
MILOW - WHATEVER IT TAKES.
JUSTIN JESSO - GETTING CLOSER
KYGO FT. TINA TURNER - WHAT'S LOVE GOT TO DO WITH IT
ED SHEERAN - AFTERGLOW
AVICII - WAKE ME UP
MILEY CYRUS - MALIBU
YOUNOTUS & JANIECK & SENEX - NARCOTIC
THE KID LAROI - WITHOUT YOU.
GALANTIS FT. ONE REPUBLIC - BONES
MAROON 5 FT. MEGAN THEE STALLION - BEAUTIFUL MISTAKES
HARRY STYLES - WATERMELON SUGAR
ZOE WEES - GIRLS LIKE US
CH-JOYA MARLEEN - NIGHTMARE
DAVID GUETTA & SIA - LET'S LOVE
COOLIO - GANGSTAS PARADISE
SHEPPARD - COMING HOME
MR PROBZ - WAVES
GAVIN JAMES - ALWAYS
MICHAEL JACKSON - THEY DON'T CARE ABOUT US
CH-HECHT - BESCH READY FýR DIE LIEBI VO MER?
ADELE - SKYFALL
AVA MAX - TORN
TOM GREGORY - RATHER BE YOU
JASON DERULO FT. NUKA - LOVE NOT WAR
BENJI & FEDE - DOVE E QUANDO
LUKAS GRAHAM - LOVE SOMEONE
CH-PEGASUS - BETTER MAN
MILKY CHANCE - STOLEN DANCE
TOPIC FT. A7S - BREAKING ME
CH-STEFANIE HEINZMANN - SHADOWS