

AVA MAX - KINGS & QUEENS
CH-ZÃƒÂ½RI WEST - FINGT DS GLÃƒÂ½CK EIM?
JAMES BLUNT - COLD
DERMOT KENNEDY - OUTNUMBERED
MANDO DIAO - DANCE WITH SOMEBODY
LOST FREQUENCIES - ARE YOU WITH ME
LIAM PAYNE FT. A BOOGIE WIT DA HOODIE - STACK IT UP
BRYAN ADAMS - EVERYTHING I DO I DO IT FOR YOU
EMINEM FT RIHANNA - LOVE THE WAY YOU LIE
CH-KUNZ - MUSIG
LEWIS CAPALDI - BEFORE YOU GO
ZOE WEES - GIRLS LIKE US
CH-LUCA HÃ½NNI - SHE GOT ME
DEAN LEWIS - 7 MINUTES
DERMOT KENNEDY - GIANTS
SAM SMITH - DIAMONDS.
OLLY MURS FT DEMI LOVATO - UP
LOST FREQUENCIES FT JANIECK DEVY - REALITY
MATTAFIX - BIG CITY LIFE
KODALINE - BROTHER
ECHOSMITH - COOL KIDS
GAVIN JAMES - ALWAYS
OWL CITY - FIREFLIES
CH-HECHT - BESCH READY FýR DIE LIEBI VO MER?
BRUNO MARS - THE LAZY SONG
BENJI & FEDE - DOVE E QUANDO
DERMOT KENNEDY - POWER OVER ME
JASON DERULO FT. NUKA - LOVE NOT WAR
REGARD - RIDE IT
FREYA RIDINGS - CASTLES
CH-PEGASUS - BETTER MAN
LADY GAGA - ALWAYS REMEMBER US THIS WAY
THE WEEKND - SAVE YOUR TEARS
EVANESCENCE - BRING ME TO LIFE
R. CITY FT ADAM LEVINE - LOCKED AWAY
SHEPPARD - GERONIMO
JONAS BROTHERS - ONLY HUMAN
AURA DIONE - I WILL LOVE YOU MONDAY