

CH-POLO HOFER - STÃƒÆ’Ã†â€™Ãƒâ€ Ã¢â‚¬â„¢ÃƒÆ’Ã¢â‚¬Å¡Ãƒâ€šÃ‚Â¯ÃƒÆ’Ã†â€™ÃƒÂ¢Ã¢â€šÂ¬Ã…Â¡ÃƒÆ’Ã¢â‚¬Å¡Ãƒâ€šÃ‚Â¿ÃƒÆ’Ã†â€™ÃƒÂ¢Ã¢â€šÂ¬Ã…Â¡ÃƒÆ’Ã¢â‚¬Å¡Ãƒâ€šÃ‚Â½EHL EWÃƒÆ’Ã†â€™Ãƒâ€ Ã¢â‚¬â„¢ÃƒÆ’Ã¢â‚¬Å¡Ãƒâ€šÃ‚Â¯ÃƒÆ’Ã†â€™ÃƒÂ¢Ã¢â€šÂ¬Ã…Â¡ÃƒÆ’Ã¢â‚¬Å¡Ãƒâ€šÃ‚Â¿ÃƒÆ’Ã†â€™ÃƒÂ¢Ã¢â€šÂ¬Ã…Â¡ÃƒÆ’Ã¢â‚¬Å¡Ãƒâ€šÃ‚Â½G
FA-COCORICO HÃƒÆ’Ã†â€™Ãƒâ€ Ã¢â‚¬â„¢ÃƒÆ’Ã¢â‚¬Å¡Ãƒâ€šÃ‚Â½NENBERG - FAIRYTALE GONE BAD
MACKLEMORE FT ZIGGY STARDUST - AND WE DANCED
CLEAN BANDIT AND MABEL FT. 24GOLDN - TICK TOCK
BLACK EYED PEAS - SHUT UP
JAMES BROWN - I FEEL GOOD
BACKSTREET BOYS - LARGER THAN LIFE
CH-PATENT OCHSNER - W. NUSS VO BÃƒÆ’Ã†â€™Ãƒâ€šÃ‚Â½MPLIZ
MICKIE KRAUSE - SCHATZI SCHENK MIR EIN FOTO
ERIC PRYDZ - CALL ON ME
LOS LOBOS - LA BAMBA
CH-ZÃƒÆ’Ã‚Â½RI WEST - I HA DI GÃƒÆ’Ã‚Â½RN GHA
BEATLES - ALL YOU NEED IS LOVE
ACE OF BASE - ALL THAT SHE WANTS
JONAS BLUE FT. JP COOPER - PERFECT STRANGERS
CH-HECHT - BESCH READY FÃƒÂ½R DIE LIEBI VO MER?
SANTANA - SMOOTH
LADY GAGA - ALEJANDRO
AXWELL & INGROSSO FT. TREVOR GUTHRIE - DREAMER
DIE PRINZEN - DÃ½RFEN DARF MAN ALLES
AVICII FT. SANDRO CAVAZZA - WITHOUT YOU
BANANARAMA - VENUS
RIHANNA - DON'T STOP THE MUSIC
BEN L'ONCLE SOUL - SEVEN NATION ARMY
DAFT PUNK FT PHARRELL WILLIAMS - GET LUCKY
UMBERTO TOZZI - GLORIA
UDO Jï¿½RGENS - GRIECHISCHER WEIN
EUROPE - THE FINAL COUNTDOWN
CH-DABU FANTASTIC - ANGELINA
MEGHAN TRAINOR - LIPS ARE MOVIN
OASIS - DON'T LOOK BACK IN ANGER
CYNDI LAUPER - GIRLS JUST WANT TO HAVE FUN
FA-SONNECHýBLER ýBIKE - VIERWALDSTýTTERSEE
CH-STUBETE G�NG - 2020 D�NN FIIR ICH HALT �LLEI
BELINDA CARLISLE - HEAVEN IS A PLACE ON EARTH
CARLY RAE JEPSEN - CALL ME MAYBE
AVA MAX - MY HEAD & MY HEART