

CH-STEFANIE HEINZMANN - MY MAN IS A MEAN MAN
MARK FORSTER - Ã½BERMORGEN
TOPIC FT. A7S - BREAKING ME
LP - GIRLS GO WILD
REGARD - RIDE IT
BRYAN ADAMS - SUMMER OF 69
DENNIS LLOYD - ANXIOUS
CASSANDRA STEEN & ADEL TAWIL - STADT
LINKIN PARK AND KIIARA - HEAVY
ALLE FARBEN & CH-ILIRA - FADING
DOTAN - THERE WILL BE A WAY
ZOE WEES - GIRLS LIKE US
CH-JOYA MARLEEN - NIGHTMARE
TOTO - AFRICA
THE KID LAROI - WITHOUT YOU.
CLEAN BANDIT FT. ANNE-MARIE - ROCKABYE
ONE REPUBLIC - COUNTING STARS
SELENA GOMEZ - BACK TO YOU
CH-GOTTHARD - HEAVEN.
MARK RONSON FT. MILEY CYRUS - NOTHING BREAKS LIKE A HEART
DERMOT KENNEDY - OUTNUMBERED
GEORGE EZRA - SHOTGUN
NELLY FT KELLY ROWLAND - DILEMMA
PURPLE DISCO MACHINE & SOPHIE AND THE GIANTS - HYPNOTIZED
BTS - DYNAMITE
WINCENT WEISS - WER WENN NICHT WIR
KYGO & WHITNEY HOUSTON - HIGHER LOVE
CH-PEGASUS - BETTER MAN
YOUNOTUS & JULIAN PERRETTA - YOUR FAVOURITE SONG
PINK - TRY
KELVIN JONES - CALL YOU HOME
BRUNO MARS - JUST THE WAY YOU ARE
MAX GIESINGER - 80 MILLIONEN
CLEAN BANDIT AND MABEL FT. 24GOLDN - TICK TOCK
IRENE CARA - WHAT A FEELING
DOTAN - NUMB
CH-BASTIAN BAKER - DANCING WITHOUT YOU
LEWIS CAPALDI - SOMEONE YOU LOVED
JASON DERULO FT. NUKA - LOVE NOT WAR
CRAZY TOWN - BUTTERFLY
LUKAS GRAHAM - 7 YEARS
COLDPLAY - PARADISE.
CH-STEFANIE HEINZMANN FT. JAKE ISAAC - ALL WE NEED IS LOVE
ED SHEERAN & JUSTIN BIEBER - I DON'T CARE
THE WEEKND - SAVE YOUR TEARS
HALSEY - YOU SHOULD BE SAD
CH-LOCO ESCRITO - AMAME