

ANDREAS GABALIER - HULAPALU
AVICII FT. SANDRO CAVAZZA - WITHOUT YOU
OFENBACH & QUARTERHEAD FT. NORMA JEAN MARTINE - HEAD SHOULDERS KNEES & TOES
THE WEEKND - SAVE YOUR TEARS
WESTLIFE - UPTOWN GIRL
DRAFI DEUTSCHER - MARMOR STEIN UND EISEN BRICHT
CH-PATENT OCHSNER - W. NUSS VO BÃƒÆ’Ã†â€™Ãƒâ€šÃ‚Â½MPLIZ
LOS LOBOS - LA BAMBA
QUEEN - THE SHOW MUST GO ON
WOLFGANG PETRY - WAHNSINN
KINGS OF LEON - USE SOMEBODY
CH-KUNZ - MARIE
FA-MUOTA GNOMÃƒÆ’Ã‚Â½ IBACH - BREAKFAST AT TIFFANY'S
BEATLES - HELP
AXWELL & INGROSSO - MORE THAN YOU KNOW
MILEY CYRUS - MIDNIGHT SKY
PURPLE DISCO MACHINE & SOPHIE AND THE GIANTS - HYPNOTIZED
SIA FT. SEAN PAUL - CHEAP THRILLS
SHAKIRA - HIPS DON'T LIE
KOOL & THE GANG - LADIES NIGHT
ROXETTE - SLEEPING IN MY CAR
CLEAN BANDIT AND MABEL FT. 24GOLDN - TICK TOCK
AVICII - HEY BROTHER
JOHANNES OERDING - AN GUTEN TAGEN
RUDIMENTAL FT. JESS GLYNNE MACKLEMORE & DAN CAPLEN - THESE DAYS
CH-PATENT OCHSNER - FISCHER
DJ ÃƒÂ½TZI & MARC PIRCHER - 7 SÃƒÂ½NDEN
BONEY M - DADDY COOL
THE WEEKND - BLINDING LIGHTS
FEDER FT LYSE - GOODBYE
FLO RIDA - GOOD FEELING
KILLERS - HUMAN.
JASON DERULO - TAKE YOU DANCING
ED SHEERAN FT. CAMILA CABELLO - SOUTH OF THE BORDER
ZUCCHERO - BAILA
GAMPER & DADONI FT. EMILY ROBERTS - BITTERSWEET SYMPHONY
ROBIN SCHULZ FT. JAMES BLUNT - OK
CH-GÃ½LÃ½ & TRAUFFER - BÃ½ETZER BUEBE
HOWARD CARPENDALE - HELLO AGAIN
KATY PERRY FT. SKIP MARLEY - CHAINED TO THE RHYTHM
FA-RASSELBANDI HORW - POISON
OASIS - WONDERWALL
ABBA - WATERLOO
TOM JONES FT MOUSSE T - SEX BOMB
SIMPLE MINDS - DON'T YOU FORGET ABOUT ME
BENJI & FEDE - DOVE E QUANDO
USHER - DJ GOT US FALLIN IN LOVE
CHUMBAWAMBA - TUBTHUMPING
DIE PRINZEN - DýRFEN DARF MAN ALLES
CH-DJ ANTOINE VS MAD MARK - BELLA VITA
JOEL CORRY FT. MNEK - HEAD & HEART
ALLE FARBEN & JUSTIN JESSO - AS FAR AS FEELINGS GO
TOPIC FT. A7S - BREAKING ME
KYGO FT. TINA TURNER - WHAT'S LOVE GOT TO DO WITH IT
SELENA GOMEZ & MARSHMELLO - WOLVES