

MICHAEL PATRICK KELLY - BEAUTIFUL MADNESS
KYGO FT. DONNA SUMMER - HOT STUFF
AVA MAX - KINGS & QUEENS
ED SHEERAN FT. CAMILA CABELLO - SOUTH OF THE BORDER
ADEL TAWIL - 1000 GUTE GRÃƒÂ½NDE
JASON DERULO - TAKE YOU DANCING
CH-STEFANIE HEINZMANN - SHADOWS
GAVIN JAMES - HEARTS ON FIRE
LEWIS CAPALDI - BEFORE YOU GO
LP - GIRLS GO WILD
FREYA RIDINGS - CASTLES
CH-DAMIAN LYNN - 2020 FUCKED ME UP
WALKING ON CARS - SPEEDING CARS
NATALIE IMBRUGLIA - TORN
KWABS - WALK
SHAWN MENDES - THERE'S NOTHING HOLDIN' ME BACK
DAVID GUETTA & SIA - LET'S LOVE
THE ALL AMERICAN REJECTS - GIVES YOU HELL
LADY GAGA - MILLION REASONS
GEORGE EZRA - SHOTGUN
KYGO & ONE REPUBLIC - LOSE SOMEBODY
DADDY YANKEE FT. SNOW - CON CALMA
CH-KUNZ - VIERWALDSTÃ½TTERSEE
ALESSIA CARA - SCARS TO YOUR BEAUTIFUL
PURPLE DISCO MACHINE & SOPHIE AND THE GIANTS - HYPNOTIZED
PANIC! AT THE DISCO - HIGH HOPES.
BRUNO MARS - GRENADE
DUA LIPA - PHYSICAL
OWL CITY - FIREFLIES
REA GARVEY - TALK TO YOUR BODY
PINK - WALK ME HOME
NICO SANTOS - PLAY WITH FIRE
EVANESCENCE - BRING ME TO LIFE
ED SHEERAN - PERFECT
OLLY MURS FT DEMI LOVATO - UP
DERMOT KENNEDY - GIANTS
DEAN LEWIS - 7 MINUTES
CH-STEFANIE HEINZMANN - IN THE END
MILEY CYRUS - MALIBU
CH-ZýRI WEST - I SCHýNKE DR MIS HýRZ
CH-CRIMER - EYES OFF ME
KYGO & WHITNEY HOUSTON - HIGHER LOVE
MILOW - FIRST DAY OF MY LIFE
EROS RAMAZZOTTI FT. TINA TURNER - COSE DELLA VITA
NICKELBACK - SONG ON FIRE
CH-LO & LEDUC - TRIBUT
MARSHMELLO FT. BASTILLE - HAPPIER.
THE BLOODHOUND GANG - THE BAD TOUCH
CH-PEGASUS & ANNA ROSSINELLI - VICTORIA LINE
ANNE-MARIE - 2002
FRITZ KALKBRENNER - BACK HOME
REM - LOSING MY RELIGION
ALAN WALKER - ALONE
DIE TOTEN HOSEN - TAGE WIE DIESE
ED SHEERAN - SHAPE OF YOU
ROBBIE WILLIAMS - SHE'S THE ONE
SIA - UNSTOPPABLE