

MAROON 5 - MEMORIES
TOM GRENNAN - LITTLE BIT OF LOVE
CH-STEFANIE HEINZMANN - COLORS
ONE REPUBLIC - RESCUE ME
CH-DAMIAN LYNN - BLINK OF AN EYE
ALVARO SOLER - MAGIA
CH-BLIGG - MANHATTAN
RITA ORA - ANYWHERE
IMAGINE DRAGONS - FOLLOW YOU
AVA MAX - SO AM I
ED SHEERAN - AFTERGLOW
OFENBACH FT. LAGIQUE - WASTED LOVE
JAMES ARTHUR - SAY YOU WON'T LET GO
PINK - WHO KNEW
JUSTIN TIMBERLAKE - MIRRORS
ANNE-MARIE - 2002
REA GARVEY - TALK TO YOUR BODY
FERGIE - BIG GIRLS DON'T CRY
MATT SIMONS - WE CAN DO BETTER
HALSEY - YOU SHOULD BE SAD
TOPIC FT. A7S - BREAKING ME
MARK FORSTER - ÃœBERMORGEN
LILLY WOOD & THE PRICK & ROBIN SCHULZ - PRAYER IN C
ROBBIE WILLIAMS - LOVE MY LIFE
ONE REPUBLIC - RUN.
ED SHEERAN & JUSTIN BIEBER - I DON'T CARE
ALOE BLACC - I NEED A DOLLAR
TOM GREGORY - SMALL STEPS
JUSTIN WELLINGTON FT. SMALL JAM - IKO IKO
HOZIER - TAKE ME TO CHURCH
IMANY - DON'T BE SO SHY (FILATOV & KARAX REMIX)
OLIVIA RODRIGO - GOOD 4 U
SAM SMITH - DIAMONDS.
CH-LOCO ESCRITO - MAMACITA.
ED SHEERAN FT. KHALID - BEAUTIFUL PEOPLE
GREEN DAY - BOULEVARD OF BROKEN DREAMS
AVA MAX - EVERYTIME I CRY
JAMES ARTHUR - FALLING LIKE THE STARS
RAG'N'BONE MAN - ALL YOU EVER WANTED
PLAIN WHITE TS - HEY THERE DELILAH
ZOE WEES - CONTROL
SHAWN MENDES & CAMILA CABELLO - SENORITA
DERMOT KENNEDY - GIANTS