

TOPIC FT. A7S - BREAKING ME
SAM SMITH - DIAMONDS.
CH-KUNZ - LÃƒÆ’Ã‚Â½ÃƒÆ’Ã‚Â½T SO WIE MER
DON HENLEY - BOYS OF SUMMER
VIZE & TOM GREGORY - NEVER LET ME DOWN
ED SHEERAN FT. FELIX JAEHN - PHOTOGRAPH
PHIL COLLINS - TWO HEARTS
SIDO FT. ANDREAS BOURANI - ASTRONAUT
THE MAMAS & THE PAPAS - CALIFORNIA DREAMIN
TAYLOR SWIFT - BLANK SPACE
MR PRESIDENT - COCO JAMBO
CH-LOCO ESCRITO - ADIÃƒÂ½S
CH-GÃ½LÃ½ - I HÃ½TT NO VIU BLÃ½DER TA
SHAWN MENDES - STITCHES
CHIC - LE FREAK
SUNRISE AVENUE - I HELP YOU HATE ME
DEEP BLUE SOMETHING - BREAKFAST AT TIFFANY'S
AVA MAX - KINGS & QUEENS
CH-JOYA MARLEEN - NIGHTMARE
JONAS BROTHERS - SUCKER
PURPLE DISCO MACHINE & SOPHIE AND THE GIANTS - HYPNOTIZED
WILL SMITH - MIAMI
OLIVIA RODRIGO - DRIVERS LICENSE
TOM GREGORY - SMALL STEPS
CH-STEFANIE HEINZMANN - COLORS
FREYA RIDINGS - CASTLES
CH-LO & LEDUC - TRIBUT
CLEAN BANDIT AND MABEL FT. 24GOLDN - TICK TOCK
LEWIS CAPALDI - BEFORE YOU GO
ZOE WEES - GIRLS LIKE US
CH-KUNZ - AFF
CH-LUCA HýNNI - SHE GOT ME
ROBIN SCHULZ FT. KIDDO - ALL WE GOT
AVA MAX - SALT
MEDUZA FT. DERMOT KENNEDY - PARADISE..
MICHAEL JACKSON - BILLIE JEAN
PINK - WHAT ABOUT US
JUSTIN BIEBER - SORRY