

CH-JOYA MARLEEN - NIGHTMARE
ED SHEERAN - BAD HABITS
AVA MAX - SO AM I
ALOE BLACC & PEGASUS - GREATEST SHOW ON EARTH
PINK FT. CASH CASH - CAN WE PRETEND
MARTIN GARRIX FT. BONO & THE EDGE - WE ARE THE PEOPLE.
MAROON 5 - MEMORIES
MABEL - DON'T CALL ME UP
ALVARO SOLER - MAGIA
LIAM PAYNE FT. A BOOGIE WIT DA HOODIE - STACK IT UP
DERMOT KENNEDY - GIANTS
JONAS BROTHERS FT. MARSHMELLO - LEAVE BEFORE YOU LOVE ME
KALEO - WAY DOWN WE GO
ALICIA KEYS - GIRL ON FIRE
MICHAEL JACKSON - BAD
RITA ORA - ANYWHERE
DOTAN - NUMB
FLO RIDA - WHISTLE
TOM GREGORY - SMALL STEPS
NICO SANTOS - ROOFTOP
MASTER KG FT. BURNA BOY & NOMCEBO ZIKODE - JERUSALEMA
ALIZEE - MOI LOLITA
DUA LIPA - WE'RE GOOD
THE WEEKND - SAVE YOUR TEARS
IMAGINE DRAGONS - FOLLOW YOU
AVRIL LAVIGNE - COMPLICATED
RUDIMENTAL FT. JAMES ARTHUR - SUN COMES UP
MAGIC! - RUDE
CH-ZIAN - SHOW YOU
LIAM PAYNE & RITA ORA - FOR YOU