

MEDUZA FT. DERMOT KENNEDY - PARADISE..
MIMI WEBB - GOOD WITHOUT
ROBBIE WILLIAMS - LET ME ENTERTAIN YOU
ONE REPUBLIC - RESCUE ME
MADONNA - LIKE A PRAYER
CH-77 BOMBAY STREET - EMPIRE
DAFT PUNK FT PHARRELL WILLIAMS - GET LUCKY
TOM GREGORY - SMALL STEPS
ALVARO SOLER FT. CALI Y EL DANDEE - MANANA
REAMONN - SUPERGIRL
MARTIN GARRIX FT. BONO & THE EDGE - WE ARE THE PEOPLE.
MILOW - ASAP
FREYA RIDINGS - CASTLES
CH-STEFANIE HEINZMANN - COLORS
JAMES BLUNT - THE TRUTH
LEONY - FADED LOVE
IMAGINE DRAGONS - FOLLOW YOU
PINK - TRY
GLASPERLENSPIEL - GEILES LEBEN
MILEY CYRUS - MIDNIGHT SKY
CH-ZIAN - GRATEFUL
ZOE WEES - CONTROL
THE WEEKND - TAKE MY BREATH
TOM GREGORY - RATHER BE YOU
ALVARO SOLER - MAGIA
ONE REPUBLIC - RUN.
THE KID LAROI FT. JUSTIN BIEBER - STAY
NICKELBACK - SONG ON FIRE
AEROSMITH - I DON'T WANT TO MISS A THING
CH-LUCA HÃ„NNI - SHE GOT ME
PINK FT NATE RUESS - JUST GIVE ME A REASON
OLIVIA RODRIGO - GOOD 4 U
DUA LIPA - PHYSICAL
RAY DALTON - GOOD TIMES HARD TIMES
IMAGINE DRAGONS - WRECKED
ED SHEERAN - PERFECT
OUTKAST - HEY YA
RAG'N'BONE MAN - ALL YOU EVER WANTED
CH-BLIGG - B.L.I. DOPPEL G
JAMES ARTHUR - FALLING LIKE THE STARS
TOPIC FT. A7S - BREAKING ME
LADY GAGA - PAPARAZZI
DOTAN - MERCY.
LOST FREQUENCIES FT JANIECK DEVY - REALITY
CH-JOYA MARLEEN - NIGHTMARE
DUNCAN LAURENCE - ARCADE
TAKAGI & KETRA & OMI & GIUSY FERRERI - JAMBO