

AEROSMITH - CRAZY
CH-CRIMER - EYES OFF ME
DERMOT KENNEDY - GIANTS
GEORGE EZRA - SHOTGUN
POST MALONE - CIRCLES
CH-PEGASUS - I TAKE IT ALL
JAMES MORRISON - I WON'T LET YOU GO
RAG'N'BONE MAN - SKIN
MELANIE FIONA - GIVE IT TO ME RIGHT
FUN FT JANELLE MONAE - WE ARE YOUNG
CH-LOCO ESCRITO - MI CULPA
ALAN WALKER AURA & TOMIME HARKET - DARKSIDE
BON JOVI - IT'S MY LIFE
RIHANNA & KANYE WEST & PAUL MCCARTNEY - FOURFIVESECONDS
OF MONSTERS AND MEN - LITTLE TALKS
SELENA GOMEZ - BACK TO YOU
BLUE - ALL RISE
CH-DAMIAN LYNN - BLINK OF AN EYE
NEA - SOME SAY
MATT SIMONS - OPEN UP
ROBBIE WILLIAMS - FEEL
JORIS - HERZ Ã½BER KOPF
COLDPLAY - PARADISE.
RAY BLK - RUN RUN
TOTO - AFRICA
CH-HECHT - BESCH READY FýR DIE LIEBI VO MER?
TAYLOR SWIFT - SHAKE IT OFF
GALANTIS FT. ONE REPUBLIC - BONES
ED SHEERAN & JUSTIN BIEBER - I DON'T CARE
JOEL CORRY FT. MNEK - HEAD & HEART
CH-PEGASUS - LAST NIGHT ON EARTH
TOM GREGORY - FINGERTIPS
SAM SMITH - DIAMONDS.
KYGO & WHITNEY HOUSTON - HIGHER LOVE
MASTER KG FT. BURNA BOY & NOMCEBO ZIKODE - JERUSALEMA
EVANESCENCE - BRING ME TO LIFE
FELIX JAEHN FT. JASMINE THOMPSON - AIN'T NOBODY
TRAIN - DRIVE BY
MAROON 5 - GIRLS LIKE YOU
GURU JOSH PROJECT - INFINITY 08
ED SHEERAN FT. KHALID - BEAUTIFUL PEOPLE