

PHILIP BAILEY FT PHIL COLLINS - EASY LOVER
MADONNA - MATERIAL GIRL
WHITNEY HOUSTON - I WANNA DANCE WITH SOMEBODY
BRUCE HORNSBY - THE WAY IT IS
DONNA SUMMER - SHE WORKS HARD FOR HER MONEY
STARSHIP - WE BUILT THIS CITY
TINA TURNER - PRIVATE DANCER
EURYTHMICS - SWEET DREAMS
ELTON JOHN - I'M STILL STANDING
PRINCE - PURPLE RAIN
HUEY LEWIS AND THE NEWS - THE POWER OF LOVE
BRYAN ADAMS - HEAVEN..
JOHN PARR - ST ELMOS FIRE
JOAN JETT & THE BLACKHEARTS - I LOVE ROCK'N'ROLL
MR MISTER - BROKEN WINGS
SUPERTRAMP - IT'S RAINING AGAIN
FRANCE GALL - ELLA ELLE L'A
ROLLING STONES - START ME UP
CH-POLO HOFER - ALPEROSE
HERBERT GRÖNEMEYER - MÄNNER
TAYLOR DAYNE - TELL IT TO MY HEART
MADONNA - LIKE A PRAYER
TINA TURNER - THE BEST
CULTURE CLUB - KARMA CHAMELEON
MURRAY HEAD - ONE NIGHT IN BANGKOK
IRENE CARA - FAME
GEORGE MICHAEL - CARELESS WHISPER
MIKE OLDFIELD - MOONLIGHT SHADOW
ROD STEWART - BABY JANE
DEXYS MIDNIGHT RUNNERS - COME ON EILEEN